border_size=1
usage=map

Gg          , Gg          , Gs^Vh       , Gg          , Gs^Fms      , Gg          , Gg          , Gg          , Gg          , Gg          , Gg          , Gg          
Gg          , Gg          , Aa^Vha      , Gg^Fet      , Gll^Fmf     , Gll^Fp      , Gg          , Gg          , Gg          , Gg          , Gg          , Gg          
Gg          , Gs          , Gd^Vhr      , Gd^Fetd     , Gd^Fmw      , Aa^Fpa      , Gg          , Gg          , Gg          , Gg          , Gg          , Gg          
Gg          , Gd          , Rr^Vhc      , Gs^Fds      , Aa^Fma      , Gg          , Gg          , Gg          , Gg          , Gg          , Gg          , Gg          
Gg          , Gll         , Gg^Vwm      , Gd^Fdf      , Gg          , Gg          , Gg          , Gg          , Re^Gvs      , Gg          , Gg          , Gg          
Gg          , Rb          , Rrc^Vhca    , Gs^Fdw      , Gg          , Gg          , Re^Gvs      , Re^Gvs      , Re^Gvs      , Re^Gvs      , Re^Gvs      , Gg          
Gg          , Re          , Rp^Vhcr     , Aa^Fda      , Gg          , Gg          , Gg          , Re^Gvs      , Re^Gvs      , Re^Gvs      , Gg          , Gg          
Gg          , Rd          , Gg          , Gg          , Gg          , Gg          , Gg^Gvs      , Gg^Gvs      , Gg^Gvs      , Gg          , Gg          , Gg          
Gg          , Rr          , Gg          , Gg          , Gg          , Gg^Gvs      , Gg^Gvs      , Gs^Vh       , Gg^Gvs      , Gg^Gvs      , Gg          , Gg          
Gg          , Rrc         , Gg          , Gg          , Gg          , Gg          , Gg          , Gg^Gvs      , Gg          , Gg          , Gg          , Gg          
Gg          , Rp          , Gg          , Gg          , Gg          , Gg          , Gg          , Gg          , Gg          , Gg          , Gg          , Gg          
Gg          , Gg          , Gg          , Gg          , Gg          , Gg          , Gg          , Gg          , Gg          , Gg          , Gg          , Gg          
